10 10

16 16

441 441
441 441

619 617 617 617 617 267 268 269 617 620 
442 619 617 617 617 443 444 445 620 440 
442 442 441 441 441 441 441 441 440 440 
442 442 441 264 265 265 265 265 796 440 
442 442 441 440 441 441 441 441 441 440 
442 442 441 616 3703 620 441 441 441 440 
442 442 441 441 441 440 441 441 441 440 
442 442 441 441 441 440 441 441 441 440 
442 442 441 441 441 440 441 441 441 440 
795 795 265 265 265 265 2024 2025 2026 796 

1 1 1 1 1 1 1 1 1 1 
1 1 1 1 1 1 0 1 0 1 
1 1 0 0 0 0 0 0 1 1 
1 1 0 1 3 3 3 3 3 1 
1 1 0 1 0 0 0 0 0 1 
1 1 0 1 0 1 0 0 0 1 
1 1 0 0 0 1 0 0 0 1 
0 1 0 0 0 1 0 0 0 1 
1 1 0 0 0 1 0 0 0 1 
1 1 1 1 1 1 1 0 1 1 

0 0 0 0 0 0 0 0 0 0 
0 0 0 0 0 0 0 0 0 0 
0 0 0 0 0 0 0 0 0 0 
0 0 0 0 0 0 0 0 0 0 
0 0 0 0 0 0 0 0 0 0 
0 0 0 0 0 0 0 0 0 0 
0 0 0 0 0 0 0 0 0 0 
0 0 0 0 0 0 0 0 0 0 
0 0 0 0 0 0 0 0 0 0 
0 0 0 0 0 0 0 0 0 0 

0 0 0 0 0 0 0 0 0 0 
0 0 0 0 0 0 0 0 0 0 
0 0 0 0 0 0 0 0 0 0 
0 0 0 0 0 0 0 0 0 0 
0 0 0 0 0 0 0 0 0 0 
0 0 0 0 0 0 0 0 0 0 
0 0 0 0 0 0 0 0 0 0 
0 0 0 0 0 0 0 0 0 0 
0 0 0 0 0 0 0 0 0 0 
0 0 0 0 0 0 0 0 0 0 

