10 10

1233 1233
1233 1233

1236 1324 1324 1324 1324 1324 1679 1324 1324 1497 
1237 1236 1324 1324 1324 1324 1767 1324 1497 1235 
1237 1237 1233 1233 1233 1233 1233 1233 1235 1235 
1237 1237 1233 1147 1148 1148 1148 1148 2030 1235 
1237 1237 1233 1235 1233 1233 1233 1233 1233 1235 
1237 1237 1233 1323 1855 1497 1233 1233 1233 1235 
1237 1237 1233 1233 1233 1235 1233 1233 1233 1235 
1237 1237 1233 1233 1233 1235 1233 1233 1233 1235 
1237 1237 1233 1233 1233 1235 1233 1233 1233 1235 
2031 2031 1148 1148 1233 2030 1148 1148 1148 2030 

1 1 1 1 1 1 1 1 1 1 
1 1 1 1 1 1 0 1 1 1 
1 1 0 0 0 0 0 0 1 1 
1 1 0 1 3 3 3 3 3 1 
1 1 0 1 0 0 0 0 0 1 
1 1 0 1 0 1 0 0 0 1 
1 1 0 0 0 1 0 0 0 1 
1 1 0 0 0 1 0 0 0 1 
1 1 0 0 0 1 0 0 0 1 
1 1 1 1 1 1 1 1 1 1 

0 0 0 0 0 0 0 0 0 0 
0 0 0 0 0 0 0 0 0 0 
0 0 0 0 0 0 0 0 0 0 
0 0 0 0 0 0 0 0 0 0 
0 0 0 0 0 0 0 0 0 0 
0 0 0 0 0 0 0 0 0 0 
0 0 0 0 0 0 0 0 0 0 
0 0 0 0 0 0 0 0 0 0 
0 0 0 0 0 0 0 0 0 0 
0 0 0 0 0 0 0 0 0 0 

0 0 0 0 0 0 0 0 0 0 
0 0 0 0 0 0 0 0 0 0 
0 0 0 0 0 0 0 0 0 0 
0 0 0 0 0 0 0 0 0 0 
0 0 0 0 0 0 0 0 0 0 
0 0 0 0 0 0 0 0 0 0 
0 0 0 0 0 0 0 0 0 0 
0 0 0 0 0 0 0 0 0 0 
0 0 0 0 0 0 0 0 0 0 
0 0 0 0 0 0 0 0 0 0 

